.......................................
.......................................
.......................................
.....-----------.......................
.......................................
.......................................
.......................................
.@.....................................
.----------------------------------....
.......................................